    Group  Value
        1      6
        2      8
        2     12
        3     13
        3      9
        2      9
        2     11
        1      8
        3     11
        1      4
        1      5
        1      3
        3      8
        1      4
        2      6
        2      8
        3      7
        3     12
